11111111111111
1P000001000001
1000001C1000E1
1000000000C001
11111111111111