11111111
11C00P11
1110C111
111E1111
11111111