00000000000000
0P111111111110
0111111C1111E0
01111111111110
00000000000000