11111111111111
1P000000000001
1000000C0000E1
10000000000001
11111111111111