11111111
 1000P1
  10C1
  1E1
   1